0,7,0,0,1,1,1,0,0,7,0,
0,7,0,0,1,1,1,0,0,7,0,
0,7,0,0,1,1,1,0,0,7,0,
0,7,0,0,0,1,0,0,0,7,0,
0,7,0,0,0,0,0,0,0,7,0,
0,7,0,0,1,1,1,0,0,7,0,
0,7,0,0,6,0,6,0,0,7,0,
0,7,0,1,1,0,1,1,0,7,0,
0,7,0,0,0,0,0,0,0,7,0,
0,7,0,0,0,0,0,0,0,7,0,
0,7,0,1,0,6,0,1,0,7,0,
7,7,0,1,0,1,0,1,0,7,7,
8,0,0,1,0,1,0,1,0,0,8,
9,0,0,1,0,4,0,1,0,0,9,
6,6,6,6,6,6,6,6,6,6,6,
6,6,6,6,6,6,6,6,6,6,6,