0,0,0,0,0,1,1,1,0,0,0,0,0,
0,0,0,0,0,1,1,1,0,0,0,0,0,
0,0,0,0,0,1,0,0,0,0,0,0,0,
0,0,0,0,0,1,0,0,0,0,0,0,0,
0,0,6,0,0,0,0,1,0,0,0,0,0,
0,6,6,6,0,0,0,1,0,0,0,0,0,
0,0,6,0,0,0,6,0,0,1,7,0,0,
0,0,0,0,0,0,1,0,0,7,7,0,0,
0,0,0,0,0,0,4,0,0,0,4,0,0,